Christoper	Flower
Lulu	Liggins
Elmo	Youle
Jemmy	Dalmon
Cecily	Lett
Elie	Berringer
Martita	Calderonello
Bil	Rainton
Hubie	Brasier
Alene	Rainton
Derron	Beaudry
Shandeigh	Portail
Wallie	Goggins
Ansel	Gravell
Herby	Ferne
Jamey	Vandenhoff
Angel	Kemble
Wolfy	Blackney
Netta	Spadazzi
Filide	Airs
Winny	Milward
Jerrilyn	Warde
Sayre	Lay
Jasmina	Philp
Inessa	Tomaszynski
Edee	Condy
Harald	Hartle
Korney	Simakov
Margret	Crowter
Stafford	Kares
Ugo	Keig
Justino	Willoughley
Sheri	Hannabuss
Andriana	Budge
Klement	Manford
Rayner	Darnell
Jorgan	Welbrock
Joshuah	Payn
Obediah	Sotheron
Arabelle	Tertre
Abrahan	Bootyman
Griff	Smalley
Albrecht	Houseley
Gerhardine	Boller
Rasla	Rubertis
Shandie	Halwill
Pepita	Headland
Nial	Brettoner
Phillida	Doerling
Ranee	Gotling
Winnifred	Stych
Horace	Balthasar
Rockwell	Umney
Ernestine	Cridland
Brenda	Broomfield
Ginelle	Losty
Myles	O'Sheilds
Syd	Smallman
Merci	Farnie
Carl	Grzesiewicz
Bruno	Skippon
Clarissa	Rubroe
Ruggiero	Gonoude
Arlen	Osbourne
Bear	Olliff
Antoni	Murrison
Ursa	Jozefczak
Shirl	Quilliam
Giavani	Gypson
Ennis	Sambals
Clark	Brookshaw
Towney	Shipston
Elbert	Docwra
Agatha	MacGill
Ursuline	Libreros
Tatiana	Remmer
Marin	Sweedland
Heall	Brunini
Lanny	Bottjer
Gilles	Arundale
Mariejeanne	Abramow
Nevin	Leile
Candy	de Najera
Masha	Awty
Olva	Alwell
Scot	Orgee
Deina	Antoniutti
Filbert	Dennitts
Lodovico	Stronge
Waylen	Mattheissen
Bobine	Everwin
Ettore	Casement
Estevan	Naton
Bartholomew	Stuchberry
Bruis	Ciotti
Vittoria	Ethridge
Tiphani	Lathey
Lira	De Wolfe
Helena	Bardnam
Renault	Spencer
Gan	Pauley
Danell	O'Gormley
Guthrie	Walters
Granger	Lindermann
Sheeree	Lowndes
Barr	Yellowlee
Frasier	Findlay
Roy	Grandin
Grover	Kleinstein
Garfield	Agneau
Reinaldo	Widdowfield
Aldridge	Bordiss
Kaye	Fackney
Tori	Sterman
Emmalynn	Munt
Osgood	Gartenfeld
Hildegarde	Doumenc
Merill	Rickis
Peder	Nani
Sarge	Kear
Baron	Rodbourne
Glynis	Sunnex
Martelle	Wain
Tabor	Winpenny
Drud	Guidi
Balduin	Samme
Victoir	Inett
Talbert	Fausset
Yard	Edler
Kirsteni	Edgin
Beverly	Spinola
Ivy	Reader
Brigham	Sellack
Aldon	Marcinkus
Horton	Brooke
Shannon	Browell
Wendel	Jovicic
Barbette	Izakoff
Honor	Deedes
Julia	Hawthorn
Norah	Chattell
Silvain	Tumbelty
Bogey	Yeulet
Lodovico	Attwoul
Dulcea	Assel
Evelyn	Buyers
Lindsey	Wollers
Aggi	Copplestone
Daryl	Simmig
Allayne	Larraway
Rona	Faudrie
Josselyn	Blaydon
Jacqueline	Ducrow
Freedman	Streight
Mord	Ascough
Adams	Giraudou
Nananne	Klimshuk
Maddy	Diamant
Terrie	Pavy
Bradford	Dennant
Nevin	Robberecht
Jedediah	Rickeard
Danita	Dewberry
Norry	Lackeye
Tatum	Gatland
Renie	Daft
Stephenie	Ambridge
Carney	Feather
Ives	Merrington
George	Kelinge
Godiva	Spinelli
Fonz	Greenland
Zuzana	Bestwall
Killian	Siverns
Rosalie	Clarey
Tanny	Bowering
Reinhard	Twomey
Ophelie	Ondricek
Mitchael	Creamer
Humfried	Russ
Ailee	Beedom
Warden	Melbert
Marwin	Meeron
Land	Cassidy
Hazel	Gipp
Stormy	Penman
Raddie	Nurden
Jasmine	Rays
Lynelle	Housecraft
Madlen	Golbourn
Cecilius	Julian
Tadio	Rasher
Abrahan	Banasevich
Harald	Pre
Colleen	Waiton
Lissi	Rignall
Dickie	Kwietek
Traci	Noonan
Inez	Bettam
Calida	Lapthorne
De	Rutley
Gilemette	Lyosik
Meris	Glencorse
Sherrie	Wissby
Alfy	Clibbery
Maximilian	Densell
Alf	Matuschek
Pierre	Kennelly
Morgen	Jeste
Kaitlin	Burbage
Lurlene	Rault
Gaby	Alcide
Shadow	Acres
Hanna	Grinstead
Samuele	Roby
Tarrah	Gudde
Corry	Whithalgh
Zachery	Force
Kristal	Diament
Fairlie	Tomsa
Karlan	Krzysztofiak
Harcourt	Batrim
Kippy	Skittrell
Pepillo	Andrus
Alexandre	Portigall
Lucretia	Clayhill
Gav	Darbey
Edythe	McEvon
Oliver	Mitrikhin
Jsandye	Squeers
Sonnnie	Shawel
Roselin	Georg
Washington	Winnett
Laney	Furmedge
Davie	Guthrum
Clarisse	Braben
Atlanta	Belsher
Hunfredo	Sappson
Meredeth	Aird
Colver	Pickless
Willey	Bytheway
Rick	Lamminam
Angeline	McKinney
Nollie	Mongin
Janna	Blazynski
Kristina	Leighfield
Anastasia	Bircher
Arne	Goadby
Margaretha	Bramo
Ailey	Brychan
Roch	Munn
Rosemary	Midson
Cloris	Kedwell
Lorin	Breslin
Siegfried	Tuffley
Alric	Baxstair
Dorey	Zannuto
Jeremiah	Veryard
Jeno	O' Ronan
Gracia	Belchambers
Bell	Gregorin
Bobbee	Gunner
Ximenez	Temple
Ricky	Fazakerley
Lynnea	Highnam
Marcela	Durrand
Craggy	Gomery
Dalila	Glendining
Meredith	Ubsdale
Golda	Lakenden
Carolus	Kehri
Rex	Tunnicliff
Arlan	Sarton
Arlina	Mumm
Fancy	Fidal
Levy	Bonnor
Osmond	Cary
Koren	Sholem
Bendix	Klain
Korella	Lawden
Cynthie	Nipper
Rianon	Gard
Marlowe	Noraway
Norrie	Panchin
Rodie	Lyptrade
Dianne	Ropkes
Kelley	Jukes
Saba	Wingeat
Codie	Douch
Tillie	Josskovitz
Lacee	Pavlovic
Brady	Harbisher
Eddie	Dobrowolny
Jessa	Ossulton
Lenee	Crayk
Veronique	Maunder
Joel	Pye
Lucienne	Anslow
Tallia	Duffil
Shellie	Lyne
Laurie	Mazella
Ricki	Salle
Kerrin	Gwynne
Roosevelt	Shinfield
Teodoro	Curphey
Renell	Sammon
Derek	Habershon
Doug	Thews
Myles	Adamovicz
Teddy	Delbergue
Sapphira	McCallister
Northrop	Bamlett
Ward	Le Fleming
Tomasina	Astbury
Shalne	Welham
Wilone	Roalfe
Quint	Farriar
Bunni	Grimsdith
Berke	Metschke
Nickola	Belchambers
Noby	Pagel
Lorilyn	Cheater
Coleman	Piddick
Garrot	Hudson
Benji	Dymond
Augusta	Koeppe
Skell	Roby
Henrieta	Roulston
Johnnie	Beauchop
Harman	Crewe
Burty	Reddoch
Cariotta	Kennifeck
Alvie	Van
Doy	Landis
Tailor	Hankey
Diego	Houlston
Blakelee	Ripsher
Mathe	Enterlein
Victoir	Griffey
Phylys	Custed
Sibilla	Wilce
Patric	Nettles
Abran	McLeoid
Tammie	Scoggan
Brady	Cawood
Trumaine	Sink
Delmor	Bowlas
Jocelin	Labet
Louisa	Puddicombe
Eugenia	Comins
Bailey	Luxmoore
Bert	Cunnow
Wilbert	Szanto
Keith	Dayton
Murvyn	Swithenby
Sloane	Crowdson
Chen	Getley
Dick	McCuffie
Kristi	Nurny
Henderson	Densumbe
Tonnie	Wollers
Francine	Chippendale
Orlando	Gaudon
Maible	Shand
Sigismundo	Birkhead
Shayne	Downie
Findlay	McGucken
Ky	Burborough
Chloe	Pantridge
Irma	Chesnut
Shurlocke	Evangelinos
Dominique	Segot
Gustavo	McGarahan
Brad	Dumper
Puff	Raffeorty
Warde	Hentzeler
Ted	Jentges
Tim	Rook
Barbee	Trouel
Conrad	Doyland
Foster	Tiesman
Lura	Olifaunt
Sancho	Franzelini
Luigi	Bettles
Shirline	Matzke
Pebrook	Loos
Wiatt	Jestico
Lotti	Simonsen
Roley	Rhymes
Karoline	Kleinbaum
Tracy	Boutwell
Erhard	Halfhide
Konstance	Peplay
Trina	Cheal
Carlynn	Winterborne
Jim	Ashby
Van	Want
Gannon	Vears
Ivor	Bidwell
Efren	Ebertz
Roobbie	Leighfield
Darrel	Lenin
Mikaela	Evangelinos
Elga	Etheredge
Theda	Gowdie
Grace	Coggins
Joya	While
Norma	Nicholl
Modesty	Herety
Lela	Bason
Marguerite	Isacsson
Doreen	Dwine
Diane-marie	Ambroz
Alphonso	Garvan
Trina	Eddleston
Levin	St Quenin
Shena	Hullock
Dante	Dorricott
Cazzie	Mancell
Arliene	Castanyer
Aime	Stampe
Jenilee	McFadin
Maurine	McKibbin
Lexine	Plampin
Muhammad	Loudiane
Sterne	Mattei
Kipp	Levey
Silvain	Rockell
Corbett	Frostick
Corinna	Jovicevic
Perceval	Le Breton
Sergei	Hovel
Natalya	Iggalden
Crystie	Pennino
Cyril	Traves
Karole	Casellas
Louisette	Rogister
Estele	Jillard
Karlotte	Mettericke
Catarina	Camis
Teena	Heimann
Ganny	Haggidon
Theressa	Abbys
Lil	Floyd
Jenni	Gatehouse
Ewan	Astley
Ailee	Snowding
Stacie	Gunther
Philip	Dooland
Theodore	Beverley
Muhammad	Hultberg
Rowan	Crommett
Merle	Road
Sonnie	Georgelin
Carly	Esgate
Donielle	Piele
Lidia	Camsey
Clarinda	Arnot
Lark	Marguerite
Rafaela	Jeves
Lemar	Wiburn
Luce	Crysell
Isacco	MacLaughlin
Tim	Sacaze
Joycelin	Itzkowicz
Skylar	Lammie
Alon	MacKettrick
Bethany	Melonby
Alli	Cheatle
Ingmar	Bisterfeld
Cassi	De Lisle
Ozzy	Wadley
Burnaby	Paydon
Sacha	Innocent
Lowe	Flawn
Lancelot	McClaurie
Panchito	Leppard
Lorie	Dampier
Madelle	Faichnie
Wheeler	Brokenbrow
Mariska	Lopes
Oran	Schukraft
Romona	Marquese
Pearle	Tacon
Estele	Ivoshin
Reggi	Lanaway
Butch	Haye
Corny	Emmott
Mira	Bryenton
Gina	Wye
Gillian	Morrall
Nyssa	Reape
Velvet	Bissatt
Eduardo	Haysar
Arel	Piggens
Yardley	Sautter
Harlene	Stiebler
Bobbi	Veld
Barrie	O'Doghesty
Maxine	Tumayan
Hiram	Baron
Malina	Etock
Rania	Divall
Emlen	Excell
Niki	Raittie
Odette	Rookes
Bent	Willmetts
Fletcher	Spight
Waite	Adamec
Tine	Poate
Wiley	Dumper
Gerianna	Wethered
Baillie	Jorgesen
Daffi	Stoppe
Winona	Adcocks
Griffin	Hairs
Modestia	Rubinlicht
Kylie	Fenners
Hakeem	Withur
Karla	Brecken
Codie	Silverton
Findley	Gairdner
Erina	Coyne
Phip	Wallett
Omar	Hearthfield
Colette	Lufkin
Mart	Hansen
Maribeth	Nunn
Sybila	Westney
Jen	Ridges
Garald	Kaveney
Robert	Roja
Burtie	Bockmann
Cilka	Blamire
Mil	Locker
Melli	Siggee
Dame	Sowden
Tad	Doward
Jennee	Odam
Mata	Alabaster
Gabe	Ritchie
Bernard	Penniall
Linnie	Gorman
Alysa	Fader
Phineas	Linder
Esteban	Cowhig
Woodrow	Couvert
Gabbie	Uzzell
Ernest	Swatman
Darrel	Speir
Hillie	Lake
Wenona	Thresh
Cary	Canty
Janet	Burder
Dru	Rainsdon
Freddie	Showell
Eustace	Pigdon
Gerri	Pollastrone
Rasla	Balloch
Vinnie	Bruneau
Damon	Iacomelli
April	Picken
Ulric	Richardsson
Shanon	Petcher
Johnathon	Olander
Ralph	Momford
Zahara	Lappine
Pattie	O'Clery
Oliy	Fittis
Willi	Kerrod
Rheba	Markova
Angelo	Ferretti
Elianore	Rawe
Abrahan	Giberd
Rhea	McTeague
Alonso	Safe
Darcie	Pantone
Erich	Mont
Edyth	Granham
Menard	Cockell
Raimundo	Sinncock
Cobbie	Leipnik
Murielle	Whittier
Orin	Niblo
Claus	Sperring
Allys	Moynihan
Salomo	Grover
Paton	Yewman
Gwennie	Heine
Yuri	Bohl
Morry	Hadgkiss
Arty	Folkerd
Buiron	Kampshell
Jean	Carr
Sadella	Abramovic
Dennet	Sarl
Tammara	Meekings
Marty	Zmitrichenko
Muhammad	McLarty
Manuel	Legerton
Auberta	Tomek
Atlanta	Hansie
Alasteir	Dodgshon
Bell	Hawker
Florina	Phil
Ferne	Coster
Marji	Rowthorne
Hollis	Scain
Dolli	Bruckshaw
Mohammed	Karsh
Gerald	McClaughlin
Chickie	Gerhartz
Tillie	Nellies
Maurine	de Clerc
Horten	Vamplers
Karole	Ryall
Erna	Alyutin
Eliza	Glasper
Ezri	Lalevee
Allyce	Thiolier
Delainey	Gillford
Emelyne	Olin
Fons	Roxburch
Ichabod	Learoid
Mira	Beau
Patrice	Huffey
Muhammad	Asals
Dorita	Kondratenko
Armstrong	Putland
Daryle	Fairtlough
Chico	Tasseler
Cullie	Inglesfield
Loy	Henrichs
Emmalee	Reynoollds
Aldus	Furtado
Ellyn	Bradden
Gav	Hopfner
Dag	Hawe
Brant	Hambrick
Esmeralda	Sidney
Alejandra	Bagnold
Dene	Scading
Nadia	Ert
Pasquale	Coumbe
Putnam	Darcey
Lorinda	McDavid
Dian	Hurtado
Franky	Foley
Louisette	Batchelor
Sibby	Schaumann
Waldon	Gerhold
Gerhardt	Doll
Carlo	Secombe
Candi	Lawrenz
Lyn	Derrick
Garvy	O'Corrin
Teirtza	Karlicek
Allsun	Jarrett
Violetta	Hainsworth
Gar	Deschelle
Joelle	Alchin
Alfred	Karpe
Harrie	Scowcroft
Scottie	Leathe
Justinian	MacElholm
Fredek	Diaper
Dana	Grob
Corri	Christophle
Nevsa	Trewartha
Baldwin	Dimberline
Witty	Chamberlen
Windy	Tomankiewicz
Connie	Clail
Christos	Kubek
Odelia	Manuaud
August	De Paoli
Biron	Arboine
Gwendolen	Mynott
Walton	Broyd
Bart	Brumbie
Yettie	Stygall
Danette	Jaffra
Karole	Lowry
Lothario	Pordal
Monty	Golby
Marcie	Shaul
Zollie	Gadson
Lucilia	Stave
Charlene	Fullerlove
Davy	Gioani
Wyndham	Press
Tessy	Fache
Zorana	Whitelock
Maggee	Temby
Hildagarde	Irving
Uta	Mathieson
Odilia	Kingswell
Jeanette	Wolffers
Charla	Sirl
Lindsey	Muscott
Laurie	Oppy
Bearnard	Chalk
Rosalinde	Nuccii
Doralynn	Leys
Junie	Glanton
Llewellyn	Shotton
Puff	Skoggins
De	Loblie
Florette	Mitchard
Damara	Marques
Briant	Flag
Elysia	Yitzovitz
Stu	Ballam
Kissie	Bisterfeld
Giorgi	Bang
Jodi	Coultass
William	Soutter
Jorge	Elster
Stanly	Crookes
Rosco	De Laspee
Sherlocke	Vuitton
Harvey	Sealy
Meredith	Issit
Keenan	Nelius
Dame	Lamburn
Corilla	Spickett
Riobard	Kolin
Adore	Yter
Tommy	Milazzo
Brigg	Costley
Madlen	Conti
Grantham	Ingre
Thayne	Lawranson
Madelaine	Nairn
Zorina	Axby
Kienan	Abbe
Bud	Kolis
Wilhelmina	Berndsen
Justen	Yearnsley
Sandor	Corderoy
Gilemette	Wilse
Pauly	Nazareth
Daron	Lander
Cheryl	Kenan
Barney	Simcock
Sullivan	Anfrey
Sandy	Janku
Suzann	Castlake
Nonna	Yuille
Kaylee	Eary
Willey	Smieton
Aldwin	Clementel
Raul	Fessby
Dinnie	Mourant
Noreen	Goom
Diane	Extance
Kerstin	Josilowski
Andras	Sharvill
Lenard	Beahan
Pen	Schapiro
Sharity	Fireman
Marj	Espine
Chickie	Grier
Bobine	Faichnie
Darnell	Tatem
Ashlee	Dzeniskevich
Dominick	Frossell
Minnaminnie	Tithecott
Almeda	Burdis
Burtie	Shemelt
Humbert	Peacock
Lanae	Bottleson
Blair	Hurndall
Del	Gresley
Chance	Overstreet
Cobb	Skellern
Eward	Scopham
Millisent	Hemphall
Tammie	Edgeller
Whitby	Conti
Maryrose	Blaze
Waylen	Falloon
Ciro	Rawlinson
Linell	Megarrell
George	Francecione
Ellissa	Dudmesh
Fergus	Sandison
Kathie	Scruby
Rosetta	Jaulme
Wylma	Redpath
Shelagh	Carbonell
Ezequiel	Baynton
Zonda	Chilles
Zacharias	Smalls
Mead	Dionisi
Hestia	Van den Velden
Jordain	Pelerin
Rodrigo	Huish
Walton	Semper
Tracy	Gretton
Shea	Joanaud
Zahara	Stimson
Jilly	Choake
Linnell	Luberti
Robbin	Krysztofiak
Ted	Breadmore
Giselbert	Caldaro
Sloan	Truckell
Udall	Skipp
Lesley	Radbone
Julie	Appleyard
Amble	Doyley
Sadye	Abramamovh
Roman	Jeaffreson
Jen	Lawey
Nicolina	Hallums
Elisabeth	Cleall
Julienne	Skinn
Christalle	Rantoul
Laina	Romain
Faun	Scyner
Gaven	O'Hollegan
Ware	Bywater
Al	McElvogue
Noam	Chandlar
Carlyn	Brodest
Cordelie	Scarce
Herschel	Slaten
Ira	Grinnell
Teriann	Bernath
Sanderson	Dimmack
Marlee	Amsberger
Mirabella	Patient
Maye	Cownden
Kirk	Hicken
Shoshana	Tink
Guinevere	MacAindreis
Keene	Tyres
Elfrieda	Sedgeman
Fredrika	Bracegirdle
Robin	Beagin
Ronda	Duffell
Alisander	Bomb
Clara	Bum
Nigel	Gullan
Esra	Campsall
Torrin	Andrzejewski
Ardenia	Severn
Almeda	Checchi
Roma	Threader
Abrahan	Caplis
Mikel	Pregel
Barry	Babbs
Melly	Shopcott
Emmi	Gustus
Bennie	Iaduccelli
Martita	Hollows
Ardelis	Wardingly
Averell	Cheater
Norean	Deboy
Chancey	Tebbut
Estelle	Bergstram
Maurine	Fraczak
Lucina	Fausset
Gunar	Klagge
Brew	Wiltsher
Caryl	Wilbore
Paige	Beddows
Joyce	Sibray
Ninnette	Stitcher
Sander	Krauze
Chev	Alphonso
Marion	Frise
Menard	Hallatt
Quint	Maps
Corby	Berridge
Renado	Roddy
Bat	Horlick
Edd	Albon
Zeb	Tatum
Glynis	Malicki
Matthieu	Pittway
Delcina	Darlaston
Mata	Barr
Rogerio	Piburn
Ambrosius	Camous
Isabella	Sedgeworth
Irv	Stoffer
Jed	Kilbourn
Raoul	Tunn
Candace	Casella
Mei	Shoebrook
Teodorico	Coxhell
Lila	Wapplington
Quintus	Witchell
Wilbert	Yegorchenkov
Milo	Goseling
Elsa	Casaro
Esta	Barizeret
Camella	Oldford
Cassandra	Banham
Ainsley	Scantleberry
Ophelie	Beesey
Gustavus	Burdge
Corly	Pabelik
Juliana	Willmott
Sayre	Coulbeck
Stanislas	Groucutt
Wells	Eveleigh
Hale	Ashingden
Royal	Gaize
Cesya	Moreby
Perren	Siggee
Dunc	Koop
Kenn	Venning
Dorothy	Lazell
Ingar	Wattins
Towney	Skyme
Elden	Dufoure
Jeannette	Dowthwaite
Issi	Brosini
Benji	Watsam
Benni	Wycliff
Meridith	Timny
Gwendolin	Burrus
Jemmy	Longhorne
Mahmoud	Fend
Cornie	Padrick
Jany	Mugridge
Moe	Makinson
Bekki	Suttle
Jasmine	Duplock
Tybi	Jowsey
Filip	Derycot
Abelard	Tumber
Nana	Dureden
Beverlee	Brise
Basia	Wiersma
Ingemar	Twinborne
Mortimer	Ashenhurst
Noellyn	Lanigan
Corty	Ripley
Wainwright	Langer
Demetre	Hallford
Andrey	Areles
Goraud	Bayford
Brittany	Minchinden
Edie	Jennions
Lucia	McVeigh
Tanya	Mazzeo
Martica	Boteman
Samaria	Petkens
Umberto	Lanfear
Sayer	Garstang
Rosanne	Osbaldstone
Filmer	Nason
Kelly	Fearneley
Giulietta	Sultana
Karie	Menilove
Abbey	Winsor
Judy	Gillis
Robers	Riseborough
Meryl	Weddeburn - Scrimgeour
Duff	Kiddie
Erick	Spedroni
Gerri	Massei
Cookie	D'Hooghe
Mabelle	Wilby
Jeremiah	Marte
Blinny	Lerigo
Elnar	Yare
Margo	Bradbeer
Filmer	Coneron
Rudolph	Hickenbottom
Brigid	Sazio
Ugo	Amthor
Maude	Fairbrother
Clark	MacCahee
Yankee	Hurd
Alec	Pilcher
Ron	Lasham
Vite	Danieli
Cly	Persicke
Raphael	McLoney
Bailey	Denslow
Thomas	Sollowaye
Parnell	Krolik
Crysta	Shakesbye
Baldwin	Mattisson
Ethel	Ollington
Karlis	Boddam
Case	Mallon
Nataniel	Style
Tadeo	Jeanequin
Mal	Wayman
Clint	Birmingham
Elisa	Esby
Prescott	Clowley
Annis	Redish
Taffy	Ruppelin
